0,0,0,0,0,0,0,0,0,0,2,2,2,2,2,2,2,2,2,2,1
0,1,1,1,2,2,2,2,2,0,2,2,2,1,2,2,2,2,2,2,2
0,1,1,1,2,2,2,2,2,0,2,2,2,2,2,2,2,2,1,2,3
0,1,1,1,2,2,2,2,2,0,2,2,2,2,2,2,2,2,2,2,4
0,1,1,1,2,2,2,2,2,0,2,2,2,2,2,2,2,2,2,2,5
0,1,1,2,2,2,2,2,2,0,2,2,2,3,2,2,1,2,2,2,6
0,1,1,2,2,2,2,2,2,0,2,2,1,2,2,2,2,2,2,0,7
0,1,1,2,2,2,2,2,2,0,2,2,2,2,2,2,2,2,2,0,8
0,1,1,2,2,2,2,2,2,2,2,2,2,2,2,2,2,2,2,0,9
0,1,1,2,2,2,2,2,2,0,2,2,2,2,2,2,2,2,2,2,10
0,1,1,2,2,2,2,2,2,0,2,2,2,2,2,2,2,2,2,2,1
0,1,1,1,2,2,1,2,2,0,2,2,2,2,2,2,2,2,2,2,2
0,1,1,1,2,2,1,2,2,0,2,2,2,2,2,2,2,2,2,2,3
0,1,1,1,2,2,1,2,2,0,2,2,2,2,2,2,2,2,2,2,4
0,1,1,1,2,2,2,2,2,0,2,2,2,2,2,2,2,2,2,2,5
0,1,1,1,2,1,2,2,2,0,2,2,2,2,2,2,2,2,2,2,6
0,1,1,1,2,2,2,2,2,0,2,2,2,2,2,2,2,2,2,2,7
0,1,1,1,2,2,2,2,2,0,2,2,2,2,2,2,2,2,2,2,8
0,1,1,1,2,2,2,2,2,0,2,2,2,2,2,2,2,2,2,2,9
0,1,1,1,2,2,2,2,2,0,2,2,2,2,2,2,2,2,2,2,10
0,1,1,1,2,2,2,2,2,0,2,2,2,2,2,2,2,2,2,2,1
0,1,1,1,2,2,2,2,2,0,2,2,2,2,2,2,2,2,2,2,2
0,1,1,1,2,2,2,2,2,0,2,2,2,2,2,2,2,2,2,2,3
0,1,1,1,2,2,2,2,2,0,2,2,2,2,2,2,2,2,2,2,4
0,1,1,1,2,2,2,2,2,0,2,2,2,2,2,2,2,2,2,2,5
0,1,1,1,2,2,2,2,2,0,2,2,2,2,2,2,2,2,2,2,6
0,1,1,1,1,2,2,2,2,0,2,2,2,2,2,2,2,2,2,2,7
0,1,1,1,1,2,2,2,2,0,2,2,2,2,2,2,2,2,2,2,8
0,1,1,1,1,2,2,2,2,0,2,2,2,2,2,2,2,2,2,2,9
0,1,1,1,1,2,2,2,2,0,2,2,2,2,2,2,2,2,2,2,10
0,1,2,2,2,2,2,2,2,0,2,2,2,2,2,2,2,2,2,2,1
0,1,2,2,2,2,2,2,2,0,2,2,2,2,2,2,2,2,2,2,2
0,1,2,2,1,2,2,2,2,0,2,2,2,2,2,2,2,2,2,2,3
0,1,2,2,2,2,2,2,2,0,2,2,2,2,2,2,2,2,2,2,4
0,1,2,2,2,2,2,2,2,0,2,2,2,2,2,2,2,2,2,2,5
0,1,1,2,2,2,2,2,2,0,2,2,2,2,2,2,2,2,2,2,6
0,1,1,1,2,2,2,2,2,0,2,2,2,2,2,2,2,2,2,2,7
0,1,1,1,2,2,2,2,2,0,2,2,2,2,2,2,2,2,2,2,8
0,1,1,1,2,2,2,2,2,0,2,2,2,2,2,2,2,2,2,2,9
0,1,1,1,3,3,3,3,3,0,2,2,2,2,2,2,2,2,2,2,10